"filename", "language", "JavaScript", "comment", "blank", "total"
"/home/juli22/school/codequal/L2/src/CurrencyCoverter.js", "JavaScript", 70, 58, 20, 148
"/home/juli22/school/codequal/L2/src/QuoteConverter.js", "JavaScript", 61, 54, 14, 129
"/home/juli22/school/codequal/L2/src/RateFetcher.js", "JavaScript", 38, 58, 13, 109
"/home/juli22/school/codequal/L2/src/index.js", "JavaScript", 6, 0, 2, 8
"/home/juli22/school/codequal/L2/src/lib/DataFormatter.js", "JavaScript", 35, 24, 10, 69
"/home/juli22/school/codequal/L2/src/lib/DataReader.js", "JavaScript", 34, 34, 10, 78
"/home/juli22/school/codequal/L2/src/lib/DeepCloner.js", "JavaScript", 57, 45, 16, 118
"/home/juli22/school/codequal/L2/src/lib/FormatHelper.js", "JavaScript", 59, 67, 20, 146
"/home/juli22/school/codequal/L2/src/lib/JsonFetchService.js", "JavaScript", 31, 26, 9, 66
"/home/juli22/school/codequal/L2/src/lib/RateNormalizer.js", "JavaScript", 36, 41, 12, 89
"/home/juli22/school/codequal/L2/src/lib/TypeChecker.js", "JavaScript", 23, 45, 7, 75
"/home/juli22/school/codequal/L2/src/lib/functions.js", "JavaScript", 7, 15, 3, 25
"Total", "-", 457, 467, 136, 1060